,Station,bikes out,bikes in,diff,diff_abs,imbalance ratio,ratio,class,name,longitude,latitude
0,31000,115,152,37,37,0.3217391304347826,3.2173913043478257,1,Eads St & 15th St S,-77.05323,38.858971
1,31001,142,118,-24,24,0.2033898305084746,-2.0338983050847457,0,18th St & S Eads St,-77.05332,38.85725
2,31002,259,297,38,38,0.14671814671814673,1.4671814671814674,1,Crystal Dr & 20th St S,-77.049232,38.856425
3,31003,198,234,36,36,0.18181818181818185,1.8181818181818183,1,Crystal Dr & 15th St S,-77.049593,38.86017
4,31004,158,154,-4,4,0.025974025974025976,-0.25974025974025977,0,Aurora Hills Cmty Ctr / 18th St & S Hayes St,-77.05949,38.857866
5,31005,327,317,-10,10,0.031545741324921134,-0.31545741324921134,0,Pentagon City Metro / 12th St & S Hayes St,-77.059936,38.862303
6,31006,146,181,35,35,0.23972602739726026,2.3972602739726026,1,Army Navy Dr & S Joyce St,-77.0633,38.8637
7,31007,455,382,-73,73,0.19109947643979056,-1.910994764397906,0,Crystal City Metro / 18th St & S Bell St,-77.05113172531128,38.85740496261504
8,31009,208,186,-22,22,0.11827956989247312,-1.1827956989247312,0,Crystal Dr & 27th St S,-77.051514,38.848466
9,31010,139,138,-1,1,0.007246376811594203,-0.07246376811594203,0,S Glebe Rd & Potomac Ave,-77.0502,38.8426
10,31011,191,260,69,69,0.3612565445026178,3.6125654450261777,1,Crystal Dr & 23rd St S,-77.0498,38.8533
11,31012,152,133,-19,19,0.14285714285714285,-1.4285714285714284,0,Clark St & 26th St S,-77.05152,38.850688
12,31013,113,119,6,6,0.05309734513274336,0.5309734513274336,1,Eads St & 22nd St S,-77.05341160297394,38.85438051517749
13,31014,550,852,302,302,0.5490909090909091,5.49090909090909,1,Lynn St & 19th St North,-77.070993,38.897315
14,31015,214,445,231,231,1.0794392523364489,10.794392523364486,1,Rosslyn Metro / Wilson Blvd & Ft Myer Dr,-77.072305,38.8946
15,31016,254,228,-26,26,0.11403508771929825,-1.1403508771929824,0,Clarendon Blvd & Pierce St,-77.076389,38.893438
16,31017,268,138,-130,130,0.9420289855072465,-9.420289855072463,0,Wilson Blvd & N Uhle St,-77.0846,38.891696
17,31018,114,87,-27,27,0.3103448275862069,-3.103448275862069,0,Rhodes St & 16th St N,-77.079375,38.892164
18,31019,136,121,-15,15,0.12396694214876032,-1.2396694214876034,0,Wilson Blvd & N Edgewood St,-77.0925,38.889
19,31020,188,118,-70,70,0.5932203389830508,-5.932203389830509,0,Wilson Blvd & N Franklin Rd,-77.0889,38.8904
20,31021,192,142,-50,50,0.35211267605633795,-3.52112676056338,0,Clarendon Blvd & N Fillmore St,-77.09308,38.8881
21,31022,301,222,-79,79,0.35585585585585583,-3.558558558558558,0,Clarendon Metro / Wilson Blvd & N Highland St,-77.094875,38.88786
22,31023,150,126,-24,24,0.19047619047619047,-1.9047619047619047,0,Fairfax Dr & Wilson Blvd,-77.097745,38.885801
23,31024,406,375,-31,31,0.08266666666666668,-0.8266666666666667,0,Virginia Square Metro / Monroe St & 9th St N,-77.103148,38.882788
24,31025,105,93,-12,12,0.12903225806451613,-1.2903225806451613,0,Central Library / Quincy St & 10th St N,-77.10783,38.88397
25,31026,150,75,-75,75,1.0,-10.0,0,Washington Blvd & 10th St N,-77.093485,38.884734
26,31027,101,81,-20,20,0.2469135802469136,-2.4691358024691357,0,Key Blvd & N Quinn St,-77.078408,38.896355
27,31028,63,49,-14,14,0.2857142857142857,-2.8571428571428568,0,N Veitch St & Key Blvd,-77.086063,38.893237
28,31029,214,183,-31,31,0.16939890710382513,-1.6939890710382512,0,N Veitch St & 20th St N,-77.086502,38.896923
29,31030,285,190,-95,95,0.5,-5.0,0,Lee Hwy & N Adams St,-77.089006,38.89593
30,31031,152,119,-33,33,0.2773109243697479,-2.773109243697479,0,15th St & N Scott St,-77.08095,38.89054
31,31032,68,48,-20,20,0.4166666666666667,-4.166666666666667,0,Washington Blvd & 7th St N,-77.090792,38.88081
32,31033,30,33,3,3,0.1,1.0,1,Barcroft Community Center,-77.1009886264801,38.85033657788445
33,31034,138,123,-15,15,0.12195121951219512,-1.2195121951219512,0,Fairfax Dr & N Randolph St,-77.109366,38.882629
34,31035,128,100,-28,28,0.28,-2.8000000000000003,0,N Quincy St & Glebe Rd,-77.107735,38.876393
35,31036,137,113,-24,24,0.21238938053097345,-2.1238938053097343,0,George Mason Dr & Wilson Blvd,-77.1207,38.87887
36,31037,495,437,-58,58,0.13272311212814644,-1.3272311212814645,0,Ballston Metro / Stuart St & 9th St N,-77.111768,38.881044
37,31038,145,141,-4,4,0.02836879432624113,-0.2836879432624113,0,Glebe Rd & 11th St N,-77.116817,38.883921
38,31039,309,261,-48,48,0.1839080459770115,-1.839080459770115,0,Wilson Blvd & N Quincy St,-77.107854,38.880012
39,31040,138,92,-46,46,0.5,-5.0,0,GMU / Fairfax Dr & Kenmore St,-77.10108,38.884616
40,31041,105,212,107,107,1.019047619047619,10.19047619047619,1,Prince St & Union St,-77.040363,38.803124
41,31042,242,238,-4,4,0.01680672268907563,-0.1680672268907563,0,Market Square / King St & Royal St,-77.043363,38.804718
42,31043,83,85,2,2,0.024096385542168683,0.24096385542168675,1,Saint Asaph St & Pendleton  St,-77.044664,38.810743
43,31044,147,165,18,18,0.12244897959183673,1.2244897959183674,1,King St & Patrick St,-77.049883,38.805317
44,31045,82,89,7,7,0.08536585365853659,0.853658536585366,1,Commerce St & Fayette St,-77.05293,38.805648
45,31046,83,60,-23,23,0.38333333333333336,-3.8333333333333335,0,Henry St & Pendleton St,-77.050276,38.811456
46,31047,583,463,-120,120,0.2591792656587473,-2.591792656587473,0,Braddock Rd Metro,-77.052808,38.814577
47,31048,219,99,-120,120,1.2121212121212122,-12.121212121212121,0,King St Metro South,-77.060626745224,38.80576284873485
48,31049,104,89,-15,15,0.16853932584269662,-1.6853932584269662,0,Utah St & 11th St N ,-77.113905,38.883669
49,31050,104,96,-8,8,0.08333333333333333,-0.8333333333333333,0,Barton St & 10th St N,-77.08777,38.884961
50,31051,98,88,-10,10,0.11363636363636365,-1.1363636363636362,0,Arlington Blvd & N Queen St,-77.077294,38.889365
51,31052,123,147,24,24,0.1951219512195122,1.951219512195122,1,Potomac Ave & 35th St S,-77.050537,38.844015
52,31053,112,84,-28,28,0.3333333333333333,-3.333333333333333,0,Columbia Pike & S Courthouse Rd,-77.080319,38.863833
53,31054,12,16,4,4,0.3333333333333333,3.333333333333333,1,Walter Reed Dr & 16th St S,-77.086733,38.857803
54,31055,27,44,17,17,0.6296296296296297,6.296296296296297,1,28th St & S Meade St,-77.069275,38.846222
55,31056,52,47,-5,5,0.10638297872340426,-1.0638297872340425,0,Troy St & 26th St S,-77.075104,38.847977
56,31057,26,27,1,1,0.038461538461538464,0.38461538461538464,1,Four Mile Run Dr & S Shirlington Rd,-77.085931,38.8444
57,31058,19,18,-1,1,0.05555555555555555,-0.5555555555555556,0,Columbia Pike & S Oakland St,-77.09586,38.860789
58,31059,45,53,8,8,0.17777777777777778,1.777777777777778,1,Four Mile Run Dr & S Walter Reed Dr,-77.095431,38.84736
59,31060,64,85,21,21,0.328125,3.28125,1,S Arlington Mill Dr & Campbell Ave,-77.089555,38.84232
60,31061,8,10,2,2,0.25,2.5,1,Kenmore St & 24th St S,-77.084918,38.848454
61,31062,2,1,-1,1,1.0,-10.0,0,Roosevelt Island,-77.06714,38.896553
62,31063,34,29,-5,5,0.1724137931034483,-1.7241379310344829,0,S George Mason & Four Mile Run Dr,-77.105022,38.852248
63,31064,3,4,1,1,0.3333333333333333,3.333333333333333,1,Gravelly Point,-77.039511,38.865029
64,31065,112,99,-13,13,0.13131313131313133,-1.3131313131313131,0,Pershing Dr & Wayne St,-77.08596,38.880705
65,31066,51,57,6,6,0.1176470588235294,1.1764705882352942,1,Columbia Pike & S Orme St,-77.072315,38.867262
66,31067,100,120,20,20,0.2,2.0,1,Columbia Pike & S Walter Reed Dr,-77.086599,38.862478
67,31068,51,66,15,15,0.29411764705882354,2.9411764705882355,1,Arlington Mill Cmty Center / Columbia Pike & S Dinwiddie St,-77.11153,38.856319
68,31069,166,152,-14,14,0.09210526315789473,-0.9210526315789473,0,Pershing Dr & N George Mason Dr,-77.107906,38.871822
69,31070,72,106,34,34,0.4722222222222222,4.722222222222222,1,Arlington Blvd & Fillmore St,-77.089233,38.873755
70,31071,20,21,1,1,0.05,0.5,1,Eads St & 12th St S,-77.05428,38.862753
71,31072,12,4,-8,8,2.0,-20.0,0,31st St & S Woodrow St,-77.09482,38.837666
72,31073,59,47,-12,12,0.2553191489361702,-2.553191489361702,0,Washington Blvd & Walter Reed Dr ,-77.082104,38.873219
73,31074,84,108,24,24,0.2857142857142857,2.8571428571428568,1,TJ Cmty Ctr / 2nd St & S Old Glebe Rd,-77.095596,38.869418
74,31075,36,36,0,0,0.0,0.0,1,Rolfe St & 9th St S,-77.076131,38.866471
75,31076,28,75,47,47,1.6785714285714286,16.785714285714285,1,Shirlington Transit Center / Quincy St & Randolph St,-77.087083,38.839912
76,31077,222,254,32,32,0.14414414414414414,1.4414414414414414,1,Iwo Jima Memorial / Meade & 14th St N,-77.071301,38.88992
77,31078,44,52,8,8,0.18181818181818185,1.8181818181818183,1,Arlington Blvd & S George Mason Dr,-77.104503,38.869442
78,31079,166,133,-33,33,0.2481203007518797,-2.481203007518797,0,Lee Hwy & N Cleveland St,-77.09169,38.894941
79,31080,217,162,-55,55,0.3395061728395062,-3.3950617283950617,0,Lee Hwy & N Scott St,-77.080851,38.897612
80,31081,109,72,-37,37,0.5138888888888888,-5.138888888888888,0,Duke St & John Carlyle St,-77.060866,38.804378
81,31082,101,69,-32,32,0.463768115942029,-4.63768115942029,0,Eisenhower Ave & Mill Race Ln,-77.068952,38.801111
82,31083,128,153,25,25,0.1953125,1.953125,1,Potomac Greens Dr & Slaters Ln,-77.047494,38.82175
83,31084,146,144,-2,2,0.013888888888888888,-0.1388888888888889,0,Ballenger Ave & Dulaney St,-77.063562,38.802677
84,31085,80,61,-19,19,0.3114754098360656,-3.114754098360656,0,Mount Vernon Ave & E Nelson Ave,-77.057619,38.820064
85,31086,61,93,32,32,0.5245901639344263,5.245901639344263,1,Mount Vernon Ave & E Del Ray Ave,-77.058541,38.82595
86,31087,146,123,-23,23,0.1869918699186992,-1.8699186991869918,0,Monroe Ave & Leslie Ave,-77.053096,38.820932
87,31088,101,111,10,10,0.099009900990099,0.9900990099009901,1,Mount Vernon Ave & Kennedy St,-77.059821,38.833077
88,31089,480,361,-119,119,0.3296398891966759,-3.296398891966759,0,Court House Metro / 15th St & N Uhle St,-77.084801,38.890612
89,31090,50,53,3,3,0.06,0.6,1,Long Bridge Park / Long Bridge Dr & 6th St S,-77.05003,38.865553
90,31091,192,159,-33,33,0.2075471698113208,-2.0754716981132075,0,Joyce St & 16th St S,-77.063275,38.859254
91,31092,21,20,-1,1,0.05,-0.5,0,Lee Hwy & N Monroe St,-77.104562,38.896456
92,31093,151,103,-48,48,0.4660194174757282,-4.660194174757281,0,21st St & N Pierce St,-77.078317,38.898984
93,31094,40,75,35,35,0.875,8.75,1,Lee Hwy & N Kirkwood Rd,-77.09713,38.895377
94,31095,30,10,-20,20,2.0,-20.0,0,Army Navy Dr & S Nash St,-77.06812083721161,38.86215024521491
95,31096,40,45,5,5,0.125,1.25,1,Walter Reed Dr & 8th St S,-77.08787,38.86612
96,31097,87,112,25,25,0.28735632183908044,2.8735632183908044,1,Saint Asaph St & Madison St,-77.044097,38.812718
97,31098,320,390,70,70,0.21875,2.1875,1,King St Metro North / Cameron St,-77.059817,38.80704
98,31099,66,50,-16,16,0.32,-3.2,0,Madison St & N Henry St,-77.049468,38.813485
99,31100,550,497,-53,53,0.10663983903420524,-1.0663983903420524,0,19th St & Pennsylvania Ave NW,-77.0429,38.9003
100,31101,1660,1817,157,157,0.09457831325301204,0.9457831325301205,1,14th & V St NW,-77.032112,38.917931
101,31102,911,709,-202,202,0.2849083215796897,-2.849083215796897,0,11th & Kenyon St NW,-77.027822,38.929464
102,31103,968,446,-522,522,1.1704035874439462,-11.704035874439462,0,16th & Harvard St NW,-77.036536,38.926088
103,31104,1116,929,-187,187,0.20129171151776104,-2.0129171151776104,0,Adams Mill & Columbia Rd NW,-77.042581,38.922925
104,31105,507,211,-296,296,1.4028436018957346,-14.028436018957347,0,14th & Harvard St NW,-77.0322,38.9268
105,31106,275,105,-170,170,1.619047619047619,-16.19047619047619,0,Calvert & Biltmore St NW,-77.047637,38.923203
106,31107,735,617,-118,118,0.1912479740680713,-1.912479740680713,0,Lamont & Mt Pleasant NW,-77.0388,38.9319
107,31108,1039,1141,102,102,0.09817131857555343,0.9817131857555341,1,4th & M St SW,-77.0178,38.8767
108,31109,1000,1089,89,89,0.08900000000000001,0.8899999999999999,1,7th & T St NW,-77.0222,38.9155
109,31110,1268,1190,-78,78,0.06554621848739496,-0.6554621848739496,0,20th St & Florida Ave NW,-77.0446,38.9154
110,31111,673,699,26,26,0.038632986627043085,0.3863298662704309,1,10th & U St NW,-77.0259,38.9172
111,31112,123,122,-1,1,0.008196721311475409,-0.0819672131147541,0,Harvard St & Adams Mill Rd NW,-77.043358,38.927872
112,31113,721,409,-312,312,0.7628361858190709,-7.628361858190709,0,Columbia Rd & Belmont St NW,-77.04368,38.920669
113,31114,1104,922,-182,182,0.19739696312364424,-1.9739696312364425,0,18th St & Wyoming Ave NW,-77.041571,38.918809
114,31115,606,387,-219,219,0.5658914728682171,-5.658914728682171,0,Columbia Rd & Georgia Ave NW,-77.0237946510315,38.92812111132096
115,31116,912,962,50,50,0.05482456140350877,0.5482456140350876,1,California St & Florida Ave NW,-77.04062,38.917761
116,31117,723,402,-321,321,0.7985074626865671,-7.985074626865671,0,15th & Euclid St  NW,-77.0352,38.92333
117,31118,473,422,-51,51,0.12085308056872038,-1.2085308056872037,0,3rd & Elm St NW,-77.01597,38.917622
118,31119,1041,908,-133,133,0.14647577092511013,-1.4647577092511013,0,14th & Belmont St NW,-77.031887,38.921074
119,31120,401,342,-59,59,0.17251461988304093,-1.7251461988304093,0,10th & Florida Ave NW,-77.025672,38.920387
120,31121,1093,943,-150,150,0.15906680805938495,-1.5906680805938493,0,Calvert St & Woodley Pl NW,-77.050046,38.923583
121,31122,622,402,-220,220,0.5472636815920398,-5.4726368159203975,0,16th & Irving St NW,-77.03625,38.928893
122,31123,666,231,-435,435,1.8831168831168832,-18.83116883116883,0,14th & Girard St NW,-77.032375,38.925284
123,31124,1583,968,-615,615,0.6353305785123967,-6.353305785123967,0,14th & Irving St NW,-77.032224,38.928552
124,31125,963,956,-7,7,0.007322175732217573,-0.07322175732217573,0,15th & W St NW,-77.034502,38.919086
125,31126,815,612,-203,203,0.33169934640522875,-3.3169934640522873,0,11th & Girard St NW,-77.027112,38.925636
126,31127,477,446,-31,31,0.06950672645739911,-0.695067264573991,0,22nd & H St NW,-77.048946,38.899104
127,31128,912,1045,133,133,0.14583333333333334,1.4583333333333335,1,23rd & M St NW,-77.050264,38.905303
128,31129,441,596,155,155,0.35147392290249435,3.5147392290249435,1,15th St & Pennsylvania Ave NW,-77.03338,38.89635
129,31200,1934,2489,555,555,0.2869700103412616,2.869700103412616,1,Massachusetts Ave & Dupont Circle NW,-77.0444,38.9101
130,31201,2440,2668,228,228,0.09344262295081968,0.9344262295081968,1,15th & P St NW,-77.034438,38.90985
131,31202,1312,1489,177,177,0.13490853658536586,1.3490853658536586,1,14th & R St NW,-77.032523,38.912681
132,31203,1453,1568,115,115,0.0791465932553338,0.791465932553338,1,14th & Rhode Island Ave NW,-77.0323,38.9086
133,31204,559,567,8,8,0.014311270125223612,0.14311270125223613,1,20th & E St NW,-77.045,38.8963
134,31205,662,800,138,138,0.2084592145015106,2.084592145015106,1,21st & I St NW,-77.04644858837128,38.90071062547463
135,31206,215,230,15,15,0.06976744186046513,0.6976744186046512,1,19th & E Street NW,-77.0436,38.8952
136,31207,237,132,-105,105,0.7954545454545454,-7.954545454545454,0,Georgia Ave and Fairmont St NW,-77.0222,38.9249
137,31208,369,510,141,141,0.3821138211382114,3.821138211382114,1,M St & New Jersey Ave SE,-77.0037,38.8763
138,31209,197,258,61,61,0.3096446700507614,3.096446700507614,1,1st & N St  SE,-77.0057,38.8743
139,31211,367,450,83,83,0.22615803814713895,2.26158038147139,1,Kennedy Center,-77.05557,38.897293
140,31212,1143,1215,72,72,0.06299212598425198,0.6299212598425197,1,21st & M St NW,-77.046774,38.90534
141,31213,1046,1439,393,393,0.37571701720841294,3.75717017208413,1,17th & K St NW,-77.03863,38.90276
142,31214,1483,1584,101,101,0.06810519217801753,0.6810519217801753,1,17th & Corcoran St NW,-77.0387,38.9121
143,31215,352,686,334,334,0.9488636363636364,9.488636363636363,1,Georgetown Harbor / 30th St NW,-77.059219,38.9022212
144,31216,618,691,73,73,0.11812297734627833,1.1812297734627832,1,14th St & New York Ave NW,-77.031686,38.899632
145,31217,623,627,4,4,0.006420545746388443,0.06420545746388442,1,USDA / 12th & C St SW,-77.02824175357819,38.88627694506511
146,31218,734,799,65,65,0.0885558583106267,0.8855585831062671,1,L'Enfant Plaza / 7th & C St SW,-77.022241,38.886266
147,31219,518,680,162,162,0.3127413127413127,3.1274131274131274,1,10th St & Constitution Ave NW,-77.026013,38.893028
148,31220,481,475,-6,6,0.01263157894736842,-0.12631578947368421,0,US Dept of State / Virginia Ave & 21st St NW,-77.046587,38.894919
149,31221,936,1077,141,141,0.15064102564102566,1.5064102564102564,1,18th & M St NW,-77.04177886247635,38.90506687455313
150,31222,844,912,68,68,0.08056872037914692,0.8056872037914692,1,New York Ave & 15th St NW,-77.03335404396057,38.89903234416315
151,31223,1131,1056,-75,75,0.07102272727272728,-0.7102272727272728,0,Convention Center / 7th & M St NW,-77.02227,38.905737
152,31224,626,729,103,103,0.1645367412140575,1.645367412140575,1,18th & L St NW,-77.04245209693909,38.903741450919384
153,31225,516,658,142,142,0.2751937984496124,2.751937984496124,1,C & O Canal & Wisconsin Ave NW,-77.06269,38.90375
154,31226,337,222,-115,115,0.5180180180180181,-5.18018018018018,0,34th St & Wisconsin Ave NW,-77.0682,38.916442
155,31227,764,922,158,158,0.20680628272251309,2.068062827225131,1,13th St & New York Ave NW,-77.029822,38.900283
156,31228,1240,1538,298,298,0.2403225806451613,2.403225806451613,1,8th & H St NW,-77.023086,38.8997
157,31229,1926,1876,-50,50,0.026652452025586356,-0.26652452025586354,0,New Hampshire Ave & T St NW,-77.03818,38.91554
158,31230,996,1222,226,226,0.22690763052208834,2.2690763052208833,1,Metro Center / 12th & G St NW,-77.027869,38.898364
159,31231,600,750,150,150,0.25,2.5,1,14th & D St NW / Ronald Reagan Building,-77.031617,38.894514
160,31232,827,1050,223,223,0.2696493349455865,2.6964933494558645,1,7th & F St NW / National Portrait Gallery,-77.02232480049133,38.89731227340173
161,31233,960,1249,289,289,0.30104166666666665,3.0104166666666665,1,17th & K St NW / Farragut Square,-77.038322,38.902061
162,31234,912,987,75,75,0.08223684210526316,0.8223684210526316,1,20th & O St NW / Dupont South,-77.04478,38.908905
163,31235,340,393,53,53,0.15588235294117647,1.5588235294117647,1,19th St & Constitution Ave NW,-77.0436,38.8923
164,31236,716,641,-75,75,0.11700468018720747,-1.1700468018720749,0,37th & O St NW / Georgetown University,-77.071652,38.90774
165,31237,760,870,110,110,0.14473684210526316,1.4473684210526316,1,25th St & Pennsylvania Ave NW,-77.053485,38.903827
166,31238,843,939,96,96,0.11387900355871886,1.1387900355871885,1,14th & G St NW,-77.032278,38.898409
167,31239,962,1107,145,145,0.15072765072765076,1.5072765072765073,1,Rhode Island & Connecticut Ave NW,-77.03980207443237,38.905995699991145
168,31240,311,318,7,7,0.022508038585209004,0.22508038585209003,1,Ohio Dr & West Basin Dr SW / MLK & FDR Memorials,-77.04657,38.88412
169,31241,1616,1417,-199,199,0.14043754410726889,-1.404375441072689,0,Thomas Circle,-77.0325,38.9059
170,31242,822,791,-31,31,0.03919089759797725,-0.3919089759797725,0,18th St & Pennsylvania Ave NW,-77.041539,38.89968
171,31243,578,665,87,87,0.15051903114186851,1.505190311418685,1,4th & C St SW,-77.01770067214966,38.88637194054526
172,31244,903,946,43,43,0.047619047619047616,0.47619047619047616,1,4th & E St SW,-77.017445,38.88412
173,31245,963,984,21,21,0.02180685358255452,0.21806853582554517,1,7th & R St NW / Shaw Library,-77.022155,38.912719
174,31246,766,1056,290,290,0.3785900783289817,3.7859007832898173,1,M St & Pennsylvania Ave NW,-77.056887,38.905126
175,31247,1033,1137,104,104,0.10067763794772508,1.0067763794772508,1,Jefferson Dr & 14th St SW,-77.032429,38.888553
176,31248,833,846,13,13,0.0156062424969988,0.15606242496998798,1,Smithsonian-National Mall / Jefferson Dr & 12th St SW,-77.02858,38.888767
177,31249,758,821,63,63,0.08311345646437995,0.8311345646437995,1,Jefferson Memorial,-77.037413,38.879819
178,31250,536,557,21,21,0.039179104477611935,0.3917910447761194,1,20th & L St NW,-77.044789,38.903584
179,31251,780,750,-30,30,0.04,-0.4,0,12th & L St NW,-77.0284,38.903819
180,31252,519,544,25,25,0.048169556840077066,0.4816955684007707,1,21st St & Pennsylvania Ave NW,-77.046564,38.901539
181,31253,542,555,13,13,0.023985239852398525,0.23985239852398527,1,19th & K St NW,-77.04337,38.902204
182,31254,709,786,77,77,0.1086036671368124,1.0860366713681242,1,15th & K St NW,-77.03353,38.902
183,31255,789,807,18,18,0.02281368821292776,0.22813688212927757,1,24th & N St NW,-77.05152,38.9066
184,31256,555,732,177,177,0.3189189189189189,3.1891891891891895,1,10th & E St NW,-77.026064,38.895914
185,31257,871,871,0,0,0.0,0.0,1,22nd & I St NW / Foggy Bottom,-77.048911,38.90088
186,31258,1301,1341,40,40,0.030745580322828595,0.3074558032282859,1,Lincoln Memorial,-77.049426,38.888251
187,31259,231,260,29,29,0.12554112554112554,1.2554112554112553,1,20th St & Virginia Ave NW,-77.045128,38.894722
188,31260,515,469,-46,46,0.09808102345415777,-0.9808102345415779,0,23rd & E St NW ,-77.049882,38.896104
189,31261,247,310,63,63,0.2550607287449393,2.550607287449393,1,21st St & Constitution Ave NW,-77.046567,38.892459
190,31262,458,598,140,140,0.3056768558951965,3.056768558951965,1,11th & F St NW,-77.026975,38.897857
191,31263,930,917,-13,13,0.014176663031624863,-0.14176663031624864,0,10th & K St NW,-77.02622,38.9024
192,31264,702,783,81,81,0.1153846153846154,1.153846153846154,1,6th St & Indiana Ave NW,-77.01994,38.894573
193,31265,1218,1220,2,2,0.0016420361247947454,0.016420361247947456,1,5th St & Massachusetts Ave NW,-77.018677,38.90093
194,31266,1276,1168,-108,108,0.09246575342465753,-0.9246575342465753,0,11th & M St NW,-77.027137,38.905607
195,31267,1229,1207,-22,22,0.018227009113504555,-0.18227009113504555,0,17th St & Massachusetts Ave NW,-77.038359,38.908142
196,31268,874,909,35,35,0.04004576659038902,0.4004576659038902,1,12th & U St NW,-77.028139,38.916787
197,31269,641,575,-66,66,0.11478260869565216,-1.1478260869565218,0,3rd St & Pennsylvania Ave SE,-77.001955,38.887378
198,31270,548,687,139,139,0.25364963503649635,2.5364963503649633,1,8th & D St NW,-77.02324,38.894851
199,31271,836,859,23,23,0.02751196172248804,0.2751196172248804,1,Constitution Ave & 2nd St NW/DOL,-77.013917,38.892275
200,31272,611,769,158,158,0.25859247135842883,2.5859247135842884,1,Washington & Independence Ave SW/HHS,-77.013769,38.886978
201,31273,148,163,15,15,0.10135135135135136,1.0135135135135136,1,Hains Point/Buckeye & Ohio Dr SW,-77.03023,38.878433
202,31274,485,608,123,123,0.2536082474226804,2.536082474226804,1,10th & G St NW,-77.02623546123505,38.89824328774852
203,31275,975,1028,53,53,0.05435897435897436,0.5435897435897437,1,New Hampshire Ave & 24th St NW,-77.051084,38.901755
204,31276,658,698,40,40,0.06079027355623101,0.60790273556231,1,15th & L St NW,-77.034846,38.90366
205,31277,985,1030,45,45,0.045685279187817264,0.45685279187817257,1,17th & G St NW,-77.03973233699799,38.89829964921176
206,31278,1047,1050,3,3,0.0028653295128939827,0.028653295128939826,1,18th & R St NW,-77.041834,38.912648
207,31279,646,628,-18,18,0.028662420382165606,-0.28662420382165604,0,19th & G St NW,-77.043182,38.898412
208,31280,636,582,-54,54,0.09278350515463918,-0.9278350515463918,0,11th & S St NW,-77.027025,38.913761
209,31281,1468,1485,17,17,0.011580381471389643,0.11580381471389645,1,8th & O St NW,-77.02277,38.90864
210,31282,731,722,-9,9,0.012465373961218836,-0.12465373961218837,0,16th & R St NW,-77.036278,38.912652
211,31283,788,828,40,40,0.05076142131979696,0.5076142131979695,1,14th & L St NW,-77.031737,38.903658
212,31284,337,383,46,46,0.13649851632047474,1.3649851632047478,1,18th & C St NW,-77.041544,38.893511
213,31285,663,749,86,86,0.1297134238310709,1.297134238310709,1,22nd & P ST NW,-77.048728,38.909394
214,31286,863,796,-67,67,0.08417085427135679,-0.8417085427135679,0,11th & O St NW,-77.02714,38.90843
215,31287,248,152,-96,96,0.631578947368421,-6.315789473684211,0,10th St & L'Enfant Plaza SW,-77.02601015567778,38.88432272414662
216,31288,842,921,79,79,0.09382422802850356,0.9382422802850355,1,4th St & Madison Dr NW,-77.017253,38.890493
217,31289,792,803,11,11,0.013888888888888888,0.1388888888888889,1,Henry Bacon Dr & Lincoln Memorial Circle NW,-77.049379,38.890544
218,31290,627,611,-16,16,0.02618657937806874,-0.2618657937806874,0,17th St & Independence Ave SW,-77.038325,38.888097
219,31291,377,432,55,55,0.14588859416445624,1.4588859416445623,1,Vermont Ave & I St NW,-77.03445106744766,38.901136451737045
220,31292,281,269,-12,12,0.044609665427509285,-0.44609665427509293,0,22nd St & Constitution Ave NW,-77.048947,38.892441
221,31293,275,522,247,247,0.8981818181818182,8.981818181818182,1,31st & Water St NW,-77.061043,38.902814
222,31294,341,346,5,5,0.014662756598240468,0.1466275659824047,1,7th & E St SW,-77.021741,38.88345
223,31295,400,561,161,161,0.4025,4.025,1,Potomac & M St NW,-77.065149,38.905368
224,31296,808,532,-276,276,0.5187969924812029,-5.18796992481203,0,Columbia & Ontario Rd NW,-77.040787,38.924088
225,31297,228,287,59,59,0.25877192982456143,2.5877192982456143,1,Virginia Ave & 25th St NW,-77.054155,38.8995
226,31298,820,796,-24,24,0.03015075376884422,-0.3015075376884422,0,15th & M St NW,-77.034674,38.905424
227,31299,772,790,18,18,0.023316062176165803,0.23316062176165803,1,Connecticut Ave & R St NW,-77.04564,38.912644
228,31300,248,282,34,34,0.13709677419354838,1.3709677419354838,1,Van Ness Metro / UDC,-77.063896,38.944551
229,31301,168,116,-52,52,0.4482758620689655,-4.482758620689655,0,Ward Circle / American University,-77.087171,38.938736
230,31302,386,247,-139,139,0.5627530364372471,-5.627530364372469,0,Wisconsin Ave & Newark St NW,-77.072755,38.934881
231,31303,378,156,-222,222,1.4230769230769231,-14.230769230769232,0,Tenleytown / Wisconsin Ave & Albemarle St NW,-77.079382,38.947607
232,31304,210,102,-108,108,1.0588235294117647,-10.588235294117647,0,36th & Calvert St NW / Glover Park,-77.070334,38.922581
233,31305,301,275,-26,26,0.09454545454545454,-0.9454545454545454,0,Connecticut Ave & Newark St NW / Cleveland Park,-77.057979,38.934267
234,31306,322,104,-218,218,2.0961538461538463,-20.961538461538463,0,39th & Calvert St NW / Stoddert,-77.077271,38.922649
235,31307,375,285,-90,90,0.3157894736842105,-3.1578947368421053,0,3000 Connecticut Ave NW / National Zoo,-77.055599,38.930282
236,31308,207,141,-66,66,0.4680851063829787,-4.680851063829787,0,39th & Veazey St NW,-77.077078,38.943837
237,31309,61,66,5,5,0.08196721311475409,0.8196721311475409,1,Fessenden St & Wisconsin Ave NW,-77.082426,38.954812
238,31310,208,156,-52,52,0.3333333333333333,-3.333333333333333,0,Connecticut & Nebraska Ave NW,-77.069956,38.955016
239,31312,511,580,69,69,0.1350293542074364,1.3502935420743638,1,Wisconsin Ave & O St NW,-77.063586,38.90849
240,31313,119,90,-29,29,0.32222222222222224,-3.2222222222222223,0,Connecticut Ave & Tilden St NW,-77.061977237463,38.94113915653008
241,31314,228,387,159,159,0.6973684210526315,6.973684210526315,1,34th & Water St NW,-77.0676684380669,38.903662690050474
242,31315,91,94,3,3,0.03296703296703297,0.32967032967032966,1,Connecticut Ave & McKinley St NW,-77.07513481378555,38.96454350924588
243,31316,77,11,-66,66,6.0,-60.0,0,Yuma St & Tenley Circle NW,-77.08059,38.946182
244,31317,95,55,-40,40,0.7272727272727273,-7.272727272727273,0,Wisconsin Ave & Ingomar St NW,-77.084636,38.958267
245,31318,65,129,64,64,0.9846153846153848,9.846153846153847,1,Connecticut Ave & Yuma St NW,-77.065115,38.947156
246,31319,146,56,-90,90,1.6071428571428572,-16.071428571428573,0,Wisconsin Ave & Brandywine St NW,-77.080217,38.949813
247,31320,62,57,-5,5,0.08771929824561403,-0.8771929824561403,0,American University East Campus,-77.087128,38.936298
248,31321,544,669,125,125,0.2297794117647059,2.297794117647059,1,15th St & Constitution Ave NW,-77.033234,38.892244
249,31400,672,552,-120,120,0.21739130434782608,-2.1739130434782608,0,Georgia & New Hampshire Ave NW,-77.024649,38.936043
250,31401,591,490,-101,101,0.20612244897959184,-2.061224489795918,0,14th St & Spring Rd NW,-77.0328,38.9375
251,31402,64,40,-24,24,0.6,-6.0,0,14th St Heights / 14th & Crittenden St NW,-77.032818,38.947774
252,31403,138,146,8,8,0.05797101449275361,0.5797101449275363,1,5th & Kennedy St NW,-77.0198142528534,38.956555547721955
253,31404,428,307,-121,121,0.3941368078175896,-3.9413680781758957,0,9th & Upshur St NW,-77.0251,38.9418
254,31405,148,110,-38,38,0.34545454545454546,-3.4545454545454546,0,Georgia Ave & Emerson St NW,-77.027333,38.949662
255,31406,232,156,-76,76,0.4871794871794872,-4.871794871794871,0,14th & Upshur St NW,-77.03267812728882,38.942475355602845
256,31407,135,74,-61,61,0.8243243243243243,-8.243243243243244,0,14th St & Colorado Ave NW,-77.032947,38.956432
257,31408,428,297,-131,131,0.44107744107744107,-4.410774410774411,0,Takoma Metro,-77.016855,38.975219
258,31411,55,39,-16,16,0.41025641025641024,-4.102564102564102,0,Georgia & Missouri Ave NW,-77.027855,38.961339
259,31412,9,39,30,30,3.333333333333333,33.333333333333336,1,3rd St & Riggs Rd NE,-77.002239,38.957463
260,31413,39,39,0,0,0.0,0.0,1,3rd & Underwood St NW,-77.016258,38.968834
261,31414,33,26,-7,7,0.2692307692307692,-2.692307692307692,0,Georgia Ave & Piney Branch Rd NW,-77.027976,38.967505
262,31415,41,30,-11,11,0.36666666666666653,-3.6666666666666665,0,Georgia Ave & Kennedy St NW,-77.02791,38.95674
263,31500,266,305,39,39,0.14661654135338345,1.4661654135338344,1,4th & W St NE,-77.000648,38.919077
264,31501,97,55,-42,42,0.7636363636363637,-7.636363636363637,0,12th & Newton St NE,-76.991016,38.933668
265,31502,173,143,-30,30,0.2097902097902098,-2.097902097902098,0,John McCormack Dr & Michigan Ave NE,-76.9955,38.9346
266,31503,702,628,-74,74,0.1178343949044586,-1.178343949044586,0,Florida Ave & R St NW,-77.0135,38.9126
267,31504,145,118,-27,27,0.2288135593220339,-2.288135593220339,0,10th & Monroe St NE,-76.992889,38.932514
268,31505,733,679,-54,54,0.07952871870397643,-0.7952871870397643,0,Eckington Pl & Q St NE,-77.00495,38.910972
269,31506,770,716,-54,54,0.07541899441340782,-0.7541899441340782,0,1st & Rhode Island Ave NW,-77.012289,38.915417
270,31507,254,109,-145,145,1.3302752293577982,-13.302752293577981,0,1st & Washington Hospital Center NW,-77.012457,38.928743
271,31508,321,292,-29,29,0.09931506849315068,-0.9931506849315068,0,Gallaudet / 8th St & Florida Ave NE,-76.9941,38.90509
272,31509,563,480,-83,83,0.17291666666666666,-1.7291666666666665,0,New Jersey Ave & R St NW,-77.017669,38.912659
273,31510,78,59,-19,19,0.3220338983050847,-3.2203389830508473,0,18th St & Rhode Island Ave NE,-76.978924,38.927095
274,31511,165,134,-31,31,0.23134328358208955,-2.3134328358208958,0,12th & Irving St NE,-76.990955,38.928644
275,31512,361,274,-87,87,0.3175182481751825,-3.1751824817518246,0,Neal St & Trinidad Ave NE,-76.987211,38.903732
276,31513,323,91,-232,232,2.5494505494505493,-25.494505494505493,0,Rhode Island Ave & V St NE,-77.004746,38.918155
277,31514,207,169,-38,38,0.2248520710059172,-2.2485207100591715,0,Hamlin & 7th St NE,-76.997194,38.927497
278,31515,96,65,-31,31,0.476923076923077,-4.769230769230769,0,Fort Totten Metro,-77.002721,38.952369
279,31516,229,222,-7,7,0.03153153153153153,-0.3153153153153153,0,Rhode Island Ave Metro,-76.995876,38.920682
280,31517,309,291,-18,18,0.061855670103092786,-0.6185567010309279,0,Union Market,-76.99707,38.907908
281,31518,188,208,20,20,0.10638297872340426,1.0638297872340425,1,New York Ave & Hecht Ave NE,-76.983683,38.915604
282,31519,599,515,-84,84,0.16310679611650486,-1.6310679611650487,0,1st & O St NW,-77.012365,38.908643
283,31520,38,48,10,10,0.2631578947368421,2.631578947368421,1,24th & R St NE / National Arboretum,-76.971923,38.91263
284,31521,14,51,37,37,2.642857142857143,26.428571428571427,1,18th & Monroe St NE,-76.979517,38.93293
285,31522,210,135,-75,75,0.5555555555555556,-5.555555555555555,0,2nd St & Seaton Pl NE,-77.00356006622314,38.914751108831155
286,31523,222,153,-69,69,0.4509803921568628,-4.509803921568627,0,Lincoln Rd & Seaton Pl NE/Harry Thomas Rec Center,-77.0078,38.915
287,31600,1525,1587,62,62,0.04065573770491803,0.4065573770491803,1,5th & K St NW,-77.019027,38.90304
288,31601,333,327,-6,6,0.01834862385321101,-0.1834862385321101,0,19th & East Capitol St SE,-76.9769,38.8896
289,31602,892,689,-203,203,0.2946298984034833,-2.946298984034833,0,Park Rd & Holmead Pl NW,-77.0315,38.9308
290,31603,1519,1580,61,61,0.04015799868334431,0.40157998683344304,1,1st & M St NE,-77.0056,38.9057
291,31604,405,408,3,3,0.007407407407407408,0.07407407407407407,1,3rd & H St NW,-77.015289,38.899408
292,31605,538,539,1,1,0.0018587360594795536,0.018587360594795536,1,3rd & D St SE,-77.0023,38.8851
293,31606,446,414,-32,32,0.07729468599033816,-0.7729468599033816,0,Potomac & Pennsylvania Ave SE,-76.9862,38.8803
294,31607,348,324,-24,24,0.07407407407407407,-0.7407407407407407,0,13th & E St SE,-76.98790669441223,38.88291548476762
295,31608,268,277,9,9,0.033582089552238806,0.33582089552238803,1,8th & Eye St SE / Barracks Row,-76.9953,38.8792
296,31609,361,477,116,116,0.32132963988919666,3.2132963988919667,1,Maine Ave & 7th St SW,-77.02305436134338,38.878693599396954
297,31610,640,618,-22,22,0.035598705501618116,-0.3559870550161812,0,Eastern Market / 7th & North Carolina Ave SE,-76.996806,38.886952
298,31611,630,696,66,66,0.10476190476190476,1.0476190476190477,1,13th & H St NE,-76.98842167854308,38.900021783466954
299,31612,704,621,-83,83,0.13365539452495975,-1.3365539452495976,0,D St & Maryland Ave NE,-76.997114,38.894758
300,31613,1590,1545,-45,45,0.029126213592233014,-0.2912621359223301,0,Eastern Market Metro / Pennsylvania Ave & 7th St SE,-76.995397,38.884
301,31614,439,497,58,58,0.13211845102505695,1.3211845102505695,1,11th & H St NE,-76.991383,38.899983
302,31615,1023,1200,177,177,0.17302052785923755,1.7302052785923756,1,6th & H St NE,-76.998347,38.899972
303,31616,935,1012,77,77,0.08235294117647059,0.8235294117647058,1,3rd & H St NE,-77.001949,38.900412
304,31617,227,240,13,13,0.05726872246696035,0.5726872246696035,1,Bladensburg Rd & Benning Rd NE,-76.982872,38.900413
305,31618,631,550,-81,81,0.14727272727272728,-1.4727272727272727,0,4th & East Capitol St NE,-77.000349,38.889955
306,31619,825,742,-83,83,0.11185983827493262,-1.1185983827493262,0,Lincoln Park / 13th & East Capitol St NE ,-76.988355,38.890461
307,31620,669,731,62,62,0.09267563527653214,0.9267563527653213,1,5th & F St NW,-77.019347,38.897222
308,31621,495,490,-5,5,0.010204081632653059,-0.1020408163265306,0,4th & D St NW / Judiciary Square,-77.016106,38.895344
309,31622,740,750,10,10,0.013513513513513514,0.13513513513513514,1,13th & D St NE,-76.987633,38.894832
310,31623,3787,4058,271,271,0.07156060205967785,0.7156060205967785,1,Columbus Circle / Union Station,-77.00493,38.89696
311,31624,1378,1568,190,190,0.1378809869375907,1.3788098693759072,1,North Capitol St & F St NW,-77.009888,38.897446
312,31625,566,519,-47,47,0.0905587668593449,-0.905587668593449,0,3rd & G St SE,-77.001828,38.881185
313,31626,357,322,-35,35,0.10869565217391304,-1.0869565217391304,0,15th St & Massachusetts Ave SE,-76.983569,38.88732
314,31627,1021,1056,35,35,0.034280117531831536,0.34280117531831533,1,3rd & M St NE,-77.0021304488182,38.905469714943266
315,31628,1003,1086,83,83,0.08275174476570289,0.827517447657029,1,1st & K St SE,-77.00572729110718,38.878854378063295
316,31629,501,426,-75,75,0.17605633802816897,-1.76056338028169,0,8th & East Capitol St NE,-76.995193,38.889988
317,31630,370,302,-68,68,0.2251655629139073,-2.251655629139073,0,15th & East Capitol St NE,-76.983326,38.889908
318,31631,546,576,30,30,0.054945054945054944,0.5494505494505495,1,8th & F St NE,-76.994749,38.897274
319,31632,436,438,2,2,0.004587155963302753,0.045871559633027525,1,15th & F St NE,-76.983575,38.897195
320,31633,425,461,36,36,0.08470588235294117,0.8470588235294118,1,Independence Ave & L'Enfant Plaza SW/DOE,-77.025762,38.887312
321,31634,583,718,135,135,0.23156089193825044,2.3156089193825045,1,3rd & Tingey St SE,-77.0024,38.87501
322,31635,237,242,5,5,0.02109704641350211,0.21097046413502107,1,Potomac Ave & 8th St SE,-76.994468,38.876737
323,31636,518,426,-92,92,0.215962441314554,-2.15962441314554,0,New Jersey Ave & N St NW/Dunbar HS,-77.01536044478416,38.90733256111448
324,31637,558,559,1,1,0.0017921146953405016,0.017921146953405017,1,North Capitol St & G Pl NE,-77.008911,38.899703
325,31638,627,656,29,29,0.04625199362041468,0.4625199362041468,1,1st & H St NW,-77.012108,38.900358
326,31639,638,726,88,88,0.13793103448275862,1.3793103448275863,1,2nd & G St NE,-77.003666,38.89967
327,31640,679,607,-72,72,0.1186161449752883,-1.186161449752883,0,Maryland Ave & E St NE,-76.9929,38.896134
328,31641,859,789,-70,70,0.08871989860583017,-0.8871989860583017,0,2nd St & Massachusetts Ave NE,-77.003135,38.894972
329,31642,218,245,27,27,0.12385321100917432,1.2385321100917432,1,4th St & K St NW,-77.01600551605225,38.90240556584194
330,31643,569,588,19,19,0.03339191564147628,0.3339191564147628,1,1st & D St SE,-77.005965,38.884916
331,31644,198,221,23,23,0.11616161616161615,1.1616161616161615,1,12th St & Pennsylvania Ave SE,-76.990121,38.882489
332,31645,398,400,2,2,0.005025125628140704,0.05025125628140704,1,6th & K St NE,-76.99838876724243,38.90235129497938
333,31646,214,285,71,71,0.3317757009345794,3.317757009345794,1,Maine Ave & 9th St SW,-77.025236,38.88044
334,31647,308,248,-60,60,0.2419354838709677,-2.4193548387096775,0,7th St & Massachusetts Ave NE,-76.99602,38.89222
335,31700,31,12,-19,19,1.5833333333333333,-15.833333333333332,0,Good Hope & Naylor Rd SE,-76.96657240390778,38.86022668950909
336,31701,6,6,0,0,0.0,0.0,1,Branch & Pennsylvania Ave SE,-76.9599,38.8692
337,31702,4,7,3,3,0.75,7.5,1,Randle Circle & Minnesota Ave SE,-76.9607,38.878
338,31703,33,25,-8,8,0.32,-3.2,0,Minnesota Ave Metro/DOES,-76.947446,38.897063
339,31704,11,14,3,3,0.2727272727272727,2.727272727272727,1,Nannie Helen Burroughs & Minnesota Ave NE,-76.941877,38.901385
340,31705,23,25,2,2,0.08695652173913042,0.8695652173913043,1,Benning Branch Library,-76.947974,38.894
341,31706,28,8,-20,20,2.5,-25.0,0,Fairfax Village,-76.952103,38.86559
342,31707,22,9,-13,13,1.4444444444444444,-14.444444444444445,0,Benning Rd & East Capitol St NE / Benning Rd Metro,-76.93723,38.889935
343,31708,54,53,-1,1,0.018867924528301886,-0.18867924528301885,0,Anacostia Ave & Benning Rd NE / River Terrace ,-76.96012,38.896544
344,31710,2,7,5,5,2.5,25.0,1,Nannie Helen Burroughs Ave & 49th St NE,-76.931862,38.898536
345,31711,8,6,-2,2,0.3333333333333333,-3.333333333333333,0,Deanwood Rec Center,-76.933099,38.908473
346,31712,220,294,74,74,0.3363636363636364,3.3636363636363638,1,Oklahoma Ave & D St NE,-76.974828,38.894474
347,31713,3,4,1,1,0.3333333333333333,3.333333333333333,1,Division Ave & Foote St NE,-76.925907,38.897407
348,31714,2,3,1,1,0.5,5.0,1,61st St & Banks Pl NE,-76.913563,38.891805
349,31715,1,2,1,1,1.0,10.0,1,37th & Ely Pl SE,-76.949709,38.883011
350,31800,45,26,-19,19,0.7307692307692307,-7.3076923076923075,0,Alabama & MLK Ave SE,-76.99937582015991,38.84322988730829
351,31801,175,156,-19,19,0.1217948717948718,-1.2179487179487178,0,Anacostia Metro,-76.994637,38.862669
352,31802,88,119,31,31,0.3522727272727273,3.522727272727273,1,Good Hope Rd & MLK Ave SE,-76.988039,38.867373
353,31803,74,61,-13,13,0.21311475409836064,-2.1311475409836063,0,Good Hope Rd & 14th St SE,-76.985238,38.866611
354,31804,35,41,6,6,0.17142857142857146,1.7142857142857144,1,Anacostia Library,-76.9784,38.865784
355,31805,37,45,8,8,0.21621621621621626,2.1621621621621623,1,Pennsylvania & Minnesota Ave SE,-76.971015,38.873057
356,31806,42,27,-15,15,0.5555555555555556,-5.555555555555555,0,Congress Heights Metro,-76.987823,38.844711
357,31807,56,46,-10,10,0.21739130434782608,-2.1739130434782608,0,Pleasant St & MLK Ave SE,-76.990037,38.863897
358,31811,5,14,9,9,1.8,18.0,1,South Capitol & Atlantic St SW,-77.008133,38.831516
359,31812,35,41,6,6,0.17142857142857146,1.7142857142857144,1,16th & Q St SE / Anacostia HS,-76.982359,38.870695
360,31813,17,16,-1,1,0.0625,-0.625,0,Alabama Ave & Stanton Rd SE / Shops at Park Village,-76.98185,38.84627
361,31814,2,7,5,5,2.5,25.0,1,Mississippi Ave & 19th St SE / THEARC,-76.97557,38.84377
362,31816,5,13,8,8,1.6,16.0,1,4th St & Mississippi Ave SE,-77.0009,38.836
363,31817,3,7,4,4,1.3333333333333333,13.333333333333332,1,1st & S Capitol St SE / Oxon Run Trail,-77.005497,38.824481
364,31818,5,9,4,4,0.8,8.0,1,Livingston Rd & 3rd St SE,-77.00223,38.82373
365,31900,25,22,-3,3,0.13636363636363635,-1.3636363636363635,0,Lee Hwy & N Woodstock St,-77.118009,38.898301
366,31901,22,22,0,0,0.0,0.0,1,Washington Blvd & N Frederick St,-77.127671,38.884829
367,31902,105,96,-9,9,0.09375,-0.9375,0,Wilson Blvd & N Illinois St ,-77.12712,38.876528
368,31903,34,40,6,6,0.17647058823529413,1.7647058823529413,1,Royal St & Wilkes St,-77.0447,38.799267
369,31904,54,51,-3,3,0.05882352941176471,-0.5882352941176471,0,East Falls Church Metro / Sycamore St & 19th St N,-77.15642720460892,38.88532071975074
370,31905,56,36,-20,20,0.5555555555555556,-5.555555555555555,0,Kennebec St & 11th St N,-77.135271,38.880992
371,31906,45,49,4,4,0.08888888888888889,0.888888888888889,1,Commonwealth Ave & Oak St,-77.061715,38.812711
372,31907,112,136,24,24,0.21428571428571427,2.142857142857143,1,Franklin St & S Washington St,-77.0487,38.798133
373,31908,46,39,-7,7,0.1794871794871795,-1.794871794871795,0,Radford St & Osage St,-77.086031,38.828437
374,31909,49,49,0,0,0.0,0.0,1,Mount Vernon Ave & Four Mile Run Park,-77.064016,38.843422
375,31910,44,51,7,7,0.1590909090909091,1.5909090909090908,1,Potomac Ave & Main Line Blvd,-77.049265,38.822738
376,31912,17,19,2,2,0.1176470588235294,1.1764705882352942,1,Mount Vernon Ave & Bruce St,-77.063093,38.841291
377,31913,74,65,-9,9,0.13846153846153847,-1.3846153846153846,0,Commonwealth Ave & E Monroe Ave,-77.06282079219818,38.82005823354218
378,31914,54,69,15,15,0.2777777777777778,2.7777777777777777,1,Lee Center,-77.053766,38.797557
379,31915,28,65,37,37,1.3214285714285714,13.214285714285714,1,Powhatan St & Bashford Ln,-77.047783,38.818748
380,31916,109,148,39,39,0.3577981651376147,3.577981651376147,1,Potomac Ave & Swann Ave,-77.047844,38.829545
381,31917,220,244,24,24,0.10909090909090907,1.0909090909090908,1,N Lynn St & Fairfax Dr,-77.070862,38.89386
382,31918,117,124,7,7,0.059829059829059825,0.5982905982905983,1,Madison St & Fairfax St,-77.040691,38.812351
383,31919,91,86,-5,5,0.05813953488372092,-0.5813953488372093,0,Carlin Springs Rd & N Thomas St,-77.112982,38.876695
384,31920,82,53,-29,29,0.5471698113207547,-5.471698113207547,0,Washington-Liberty High School / N Stafford St & Generals Way,-77.111066,38.888282
385,31921,20,37,17,17,0.85,8.5,1,Westover Library / Washington Blvd & N McKinley Rd,-77.142317,38.886048
386,31923,3,4,1,1,0.3333333333333333,3.333333333333333,1,Columbia Pike & S Taylor St,-77.103728,38.858524
387,31924,121,70,-51,51,0.7285714285714285,-7.285714285714286,0,Wilson Blvd & N Troy St,-77.082089,38.892556
388,32000,62,58,-4,4,0.06896551724137931,-0.6896551724137931,0,Norfolk Ave & Fairmont St,-77.096539,38.988562
389,32001,103,70,-33,33,0.4714285714285714,-4.714285714285714,0,Fenton St & New York Ave ,-77.023082,38.985404
390,32002,98,99,1,1,0.010204081632653059,0.1020408163265306,1,Bethesda Ave & Arlington Rd,-77.097426,38.981103
391,32003,43,36,-7,7,0.19444444444444445,-1.9444444444444444,0,Montgomery Ave & Waverly St ,-77.09221,38.983838
392,32004,2,4,2,2,1.0,10.0,1,Fallsgrove Blvd & Fallsgrove Dr,-77.192672,39.096312
393,32005,1,3,2,2,2.0,20.0,1,Traville Gateway Dr & Gudelsky Dr,-77.202501,39.093783
394,32006,34,23,-11,11,0.4782608695652174,-4.782608695652174,0,13th St & Eastern Ave,-77.029417,38.987
395,32007,16,14,-2,2,0.14285714285714285,-1.4285714285714284,0,E Montgomery Ave & Maryland Ave,-77.151291,39.084125
396,32008,57,70,13,13,0.2280701754385965,2.280701754385965,1,Cordell & Norfolk Ave,-77.098029,38.98954
397,32009,12,5,-7,7,1.4,-14.0,0,Frederick Ave & Horners Ln,-77.145213,39.094772
398,32010,24,106,82,82,3.4166666666666665,34.166666666666664,1,Philadelphia & Maple Ave,-77.011336,38.98128
399,32011,35,83,48,48,1.3714285714285714,13.714285714285715,1,Maple & Ritchie Ave,-77.006311,38.983627
400,32012,76,66,-10,10,0.15151515151515152,-1.5151515151515151,0,Silver Spring Metro / Colesville Rd & Wayne Ave,-77.02953189611435,38.99489580319022
401,32013,65,47,-18,18,0.3829787234042553,-3.829787234042553,0,Montgomery & East Ln,-77.095367,38.983525
402,32014,130,139,9,9,0.06923076923076922,0.6923076923076923,1,Friendship Hts Metro / Wisconsin Ave & Wisconsin Cir,-77.085998,38.961763
403,32015,2,9,7,7,3.5,35.0,1,Crabbs Branch Way & Redland Rd,-77.156985,39.120045
404,32016,2,3,1,1,0.5,5.0,1,Fallsgrove Dr & W Montgomery Ave,-77.188014,39.099376
405,32017,4,6,2,2,0.5,5.0,1,Monroe St & Monroe Pl,-77.149162,39.083673
406,32018,39,38,-1,1,0.02631578947368421,-0.2631578947368421,0,Needwood Rd & Eagles Head Ct,-77.15741,39.123513
407,32019,76,57,-19,19,0.3333333333333333,-3.333333333333333,0,East West Hwy & Blair Mill Rd,-77.02935,38.990249
408,32020,24,23,-1,1,0.043478260869565216,-0.43478260869565216,0,Crabbs Branch Way & Calhoun Pl,-77.152072,39.107709
409,32021,66,60,-6,6,0.1,-1.0,0,47th & Elm St,-77.091991,38.982456
410,32022,2,2,0,0,0.0,0.0,1,Dennis Ave & Amherst Ave,-77.04456299543381,39.02538719623632
411,32023,21,19,-2,2,0.10526315789473684,-1.0526315789473684,0,Montgomery College / W Campus Dr & Mannakee St,-77.159048,39.095661
412,32024,74,79,5,5,0.06756756756756757,0.6756756756756757,1,Fenton St & Gist Ave,-77.023854,38.989724
413,32025,103,81,-22,22,0.2716049382716049,-2.716049382716049,0,Carroll & Westmoreland Ave,-77.01121,38.975
414,32026,171,174,3,3,0.017543859649122806,0.17543859649122806,1,Carroll & Ethan Allen Ave,-77.006472,38.977933
415,32027,50,70,20,20,0.4,4.0,1,Battery Ln & Trolley Trail,-77.100104,38.992375
416,32028,17,20,3,3,0.17647058823529413,1.7647058823529413,1,Norfolk & Rugby Ave,-77.100239,38.990639
417,32029,44,57,13,13,0.2954545454545455,2.9545454545454546,1,Offutt Ln & Chevy Chase Dr,-77.094589,38.977093
418,32030,3,1,-2,2,2.0,-20.0,0,Broschart & Blackwell Rd,-77.200322,39.102099
419,32031,6,12,6,6,1.0,10.0,1,Taft St & E Gude Dr,-77.132954,39.094103
420,32032,18,32,14,14,0.7777777777777778,7.777777777777778,1,Fleet St & Ritchie Pkwy,-77.141378,39.076331
421,32033,20,18,-2,2,0.1111111111111111,-1.1111111111111112,0,Piccard & W Gude Dr,-77.177091,39.102212
422,32035,24,18,-6,6,0.3333333333333333,-3.333333333333333,0,Georgia Ave & Spring St,-77.031555,38.999388
423,32036,41,72,31,31,0.7560975609756098,7.560975609756097,1,Fenton St & Ellsworth Dr ,-77.025608,38.997033
424,32037,30,33,3,3,0.1,1.0,1,King Farm Blvd & Pleasant Dr,-77.171487,39.114688
425,32038,27,18,-9,9,0.5,-5.0,0,King Farm Blvd & Piccard Dr,-77.182669,39.110314
426,32039,28,24,-4,4,0.16666666666666666,-1.6666666666666665,0,Old Georgetown Rd & Southwick St,-77.109647,38.999634
427,32040,47,41,-6,6,0.14634146341463414,-1.4634146341463414,0,Friendship Blvd & Willard Ave,-77.088659,38.96115
428,32041,3,1,-2,2,2.0,-20.0,0,Medical Center Dr & Key West Ave,-77.196442,39.103091
429,32043,17,26,9,9,0.5294117647058824,5.294117647058823,1,Veterans Pl & Pershing Dr ,-77.023894,38.997445
430,32044,20,27,7,7,0.35,3.5,1,Rockville Metro East,-77.145803,39.085394
431,32045,36,40,4,4,0.1111111111111111,1.1111111111111112,1,Shady Grove Metro West,-77.166093,39.119765
432,32046,136,146,10,10,0.07352941176470587,0.7352941176470589,1,River Rd & Landy Ln,-77.103381,38.964992
433,32047,34,25,-9,9,0.36,-3.5999999999999996,0,Rockville Metro West,-77.146866,39.084379
434,32048,200,111,-89,89,0.8018018018018018,-8.018018018018019,0,Bethesda Metro / Wisconsin Ave & Old Georgetown Rd,-77.094537,38.984691
435,32049,22,25,3,3,0.13636363636363635,1.3636363636363635,1,WAU / Flower Ave & Division St,-77.000035,38.986743
436,32050,2,1,-1,1,1.0,-10.0,0,Spring St & 2nd Ave,-77.034499,38.997653
437,32052,7,7,0,0,0.0,0.0,1,Key West Ave & Siesta Key Way,-77.194774,39.105295
438,32053,47,39,-8,8,0.20512820512820512,-2.051282051282051,0,Medical Center Metro ,-77.097882,38.999378
439,32054,6,5,-1,1,0.2,-2.0,0,Lyttonsville Rd & Lyttonsville Pl,-77.051168,38.999679
440,32055,97,104,7,7,0.07216494845360824,0.7216494845360824,1,Woodmont Ave & Strathmore St,-77.093522,38.979875
441,32056,43,32,-11,11,0.34375,-3.4375,0,East West Hwy & 16th St,-77.038721,38.995681
442,32057,3,6,3,3,1.0,10.0,1,Pooks Hill Rd & Linden Ave,-77.107143,39.014716
443,32058,113,97,-16,16,0.16494845360824742,-1.6494845360824741,0,Sligo Ave & Carroll Ln,-77.016311,38.990874
444,32059,2,14,12,12,6.0,60.0,1,Takoma Park Rec Center,-76.988311,38.98265
445,32061,12,9,-3,3,0.3333333333333333,-3.333333333333333,0,New Hampshire & Kirklynn Ave,-76.988422,38.988101
446,32062,37,38,1,1,0.027027027027027032,0.2702702702702703,1,Wheaton Metro / Georgia Ave & Reedie Dr,-77.051023,39.038341
447,32063,14,13,-1,1,0.07692307692307693,-0.7692307692307693,0,Amherst Ave & Elkins St,-77.047788,39.044887
448,32064,2,2,0,0,0.0,0.0,1,Amherst Ave & Prichard Rd,-77.048395,39.035965
449,32065,26,20,-6,6,0.3,-3.0,0,Grandview & Blueridge Ave,-77.053085,39.043272
450,32066,5,13,8,8,1.6,16.0,1,Windham Ln & Amherst Ave,-77.04735,39.032029
451,32067,106,107,1,1,0.009433962264150943,0.09433962264150943,1,Shady Grove Metro East,-77.164969,39.121327
452,32068,76,61,-15,15,0.2459016393442623,-2.459016393442623,0,Columbus Ave & Tribeca St,-77.1673,39.126
453,32069,10,10,0,0,0.0,0.0,1,Columbus Ave & Gramercy Blvd,-77.16486,39.12333
454,32072,1,3,2,2,2.0,20.0,1,Key West Ave & Diamondback Dr,-77.202354,39.106152
455,32073,1,1,0,0,0.0,0.0,1,Blueridge Ave & Elkin St,-77.05006,39.04313
456,32200,6,7,1,1,0.16666666666666666,1.6666666666666665,1,Spring Hill Metro,-77.240654,38.929261
457,32201,3,3,0,0,0.0,0.0,1,Westpark Dr & Leesburg Pike,-77.235955,38.92403
458,32203,11,13,2,2,0.18181818181818185,1.8181818181818183,1,Tysons One Pl & Chain Bridge Rd,-77.221179,38.919475
459,32204,47,52,5,5,0.10638297872340426,1.0638297872340425,1,Tysons Corner Station,-77.222115,38.920939
460,32205,20,21,1,1,0.05,0.5,1,Westpark & Jones Branch Dr,-77.217664,38.924437
461,32206,11,11,0,0,0.0,0.0,1,Jones Branch & Westbranch Dr,-77.219261,38.931911
462,32207,7,9,2,2,0.2857142857142857,2.8571428571428568,1,Westpark & Park Run Dr,-77.225394,38.928919
463,32208,10,11,1,1,0.1,1.0,1,Tysons West Transit Center,-77.231825,38.932636
464,32209,11,6,-5,5,0.8333333333333334,-8.333333333333334,0,North Shore & Cameron Crescent Dr/Crescent Apartments,-77.338686,38.970046
465,32210,5,11,6,6,1.2,12.0,1,Town Center Pkwy & Bowman Towne Dr,-77.361902,38.962524
466,32211,1,2,1,1,1.0,10.0,1,Reston Regional Library,-77.358815,38.962095
467,32212,2,2,0,0,0.0,0.0,1,New Dominion Pkwy & Fountain Dr,-77.356324,38.960574
468,32213,35,36,1,1,0.028571428571428567,0.2857142857142857,1,Sunset Hills & Old Reston Ave,-77.351649,38.955079
469,32214,55,64,9,9,0.16363636363636366,1.6363636363636362,1,Reston Town Center Transit Station,-77.359718,38.957037
470,32215,171,131,-40,40,0.3053435114503817,-3.053435114503817,0,Wiehle Ave & Reston Station Blvd,-77.3368,38.9492
471,32216,18,27,9,9,0.5,5.0,1,Library St & Freedom Dr,-77.358741,38.959633
472,32217,26,19,-7,7,0.3684210526315789,-3.6842105263157894,0,Sunset Hills Rd & Discovery Square,-77.357611,38.95534
473,32218,6,5,-1,1,0.2,-2.0,0,Temporary Rd & Old Reston Ave,-77.353414,38.960084
474,32219,15,24,9,9,0.6,6.0,1,Reston YMCA,-77.368416,38.955314
475,32220,31,41,10,10,0.3225806451612903,3.225806451612903,1,Sunset Hills Rd & Isaac Newton Square,-77.340377,38.951443
476,32221,28,18,-10,10,0.5555555555555556,-5.555555555555555,0,Greensboro & International Dr,-77.227417,38.923083
477,32222,1,1,0,0,0.0,0.0,1,Towers Crescent Dr & Tysons One Pl,-77.220157,38.915246
478,32223,10,15,5,5,0.5,5.0,1,North Shore Dr & Village Rd,-77.340787,38.970412
479,32224,5,8,3,3,0.6,6.0,1,Town Center Pkwy & Sunset Hills Rd,-77.3630940914154,38.955170598044894
480,32225,4,2,-2,2,1.0,-10.0,0,Reston Pkwy & Spectrum Dr,-77.35428035259247,38.964207741006206
